과목 : Môn học  
석사 : Thạc sĩ  
진화 : Tiến hóa  
유학 : Du học  
고백하다 : Thổ lộ, bộc bạch  
연구자 : Nhà nghiên cứu  
경영자/사업가 : Người kinh doanh  
변호사 : Luật sư, biện hộ  
주부 : Nội trợ  
박사 : Tiến sĩ  
교수님 : Giáo sư  
어학연수 : Học tiếng  
대학원 : Cao học (sau đại học)  
등록금 : Tiền đăng ký, tiền học phí  
졸업 : Tốt nghiệp  
입학 : Nhập học  
봉사 활동 : Hoạt động tình nguyện  
최우수상 : Giải xuất sắc nhất  
우수상 : Giải thưởng ưu tú  
인기상 : Giải được yêu thích nhất  
꿈 : Giấc mơ  
사귀다 : Bắt đầu mối quan hệ, quen  
돌아오다 : Trở về  
끊다 : Ngắt, ngưng  
관광지 : Điểm du lịch  
운동장 : Sân vận động  
여행사 : Công ty du lịch  
호텔 : Khách sạn  
항공사 : Hàng không  
출판사 : Nhà xuất bản  
신문사 : Tòa soạn báo  
방송국 : Đài truyền hình  
무역 회사 : Công ty thương mại  
건설회사 : Công ty xây dựng  
컨설팅 회사/자문회사 : Công ty tư vấn  
공사 : Tổng cục  
산업단지 : Khu công nghiệp  
외국 투자 회사 : Công ty đầu tư nước ngoài  