 hứa hẹn: 약속하다
 hủy cuộc hẹn: 약속을 취소하다
 gặp mặt: 만나다
 giữ lời hứa: 약속을 지키다
 thay đổi cuộc hẹn: 약속을 바꾸다
 chia tay: 헤어지다
 thất hứa, không giữ lời hứa: 약속을 안 지키다/못 지키다
 chờ đợi: 기다리다
 liên lạc: 연락하다
 quán cà phê: 커피숍
 bảo tàng: 박물관
 bảo tàng mỹ thuật: 미술관
 quảng trường gặp gỡ: 만남의 광장
 khách sạn: 호텔
 trung tâm mua sắm cao cấp: 백화점
 bàn hướng dẫn: 안내 데스크
 trạm dừng xe buýt: 38 버스 정류장
 khu mua sắm: 쇼핑몰
  cảm cúm: 감기
 đột nhiên: 갑자기
 sửa chữa: 고치다
 văn phòng khoa: 학과 사무실
 quảng trường: 광장
 con đường: 길
 đi đón (ai): 마중을 나가다/나오다
 luận văn, bài báo khoa học: 논문
 chậm, muộn: 늦다
 ngủ dậy muộn: 늦잠
 thuốc lá: 담배
 chạm (tay): (손을) 대다
 giày leo núi: 등산화
 có vấn đề: 문제가 있다
 (bị, được) thay đổi: 바뀌다
 thay đổi: 변경
 ăn tự chọn: 뷔페
 sót: 빠지다
 biết: 알다
 đi ra ngoài: 외출하다
 điểm cần lưu ý: 유의 사항
 quên: 잊다
 tuyệt đối: 절대
 giờ kiểm tra (điểm danh): 점호시간
 giờ chính xác: 정각
 hút (thuốc lá): 담배를 피우다
 xác nhận, chứng thực: 확인
 hội phí: 회비
 phòng họp: 회의실 