túi: 봉지
nổi: 유행하다
đơn giản: 난순한
ngầu: 멌있다
hợp:아을리다
bộ (quần áo): 벌
đôi (giày, tất): 켤레
đôi, cặp: 쌍
tà, trang: 장
đóa, chùm, nải: 송이
giỏ: 바구니
hộp: 상자
túi nylon: 봉지
tìm: 찾다
đặt hàng: 주문하다
vừa ý: 마음에 들다
tính tiền: 계산하다
vừa: 맞다
đổi, trao đổi: 교환하다
phù hợp: 어울리다
hoàn tiền: 환불하다
ngắn: 짧다
dài: 길다
ít: 적다
nhiều: 많다
dày: 두껍다
mỏng: 얇다
nặng: 무겁다
nhẹ: 가볍다
sặc sỡ: 화려하다
đơn giản: 단순하다
thoải mái: 편하다
không thoải mái: 불편하다
quả quýt: 귤
chức năng, kỹ năng: 기능
khí thế, tâm trạng: 기분
máy tính xách tay: 노트북
ai cũng thế, mọi người: 누구나
đa dạng: 다양하다
từ vựng: 단어
thiết kế: 디자인
chỉ: 만
nhanh: 빠르다
bút chì kim: 샤프
thời trang, thịnh hành: 유행하다
sản phẩm: 제품
núi Seorak: 설악산
thẻ (thẻ tín dụng): 카드
khu mua sắm: 쇼핑몰
chắc chắn: 튼튼하다
một cách dễ dàng: 쉽게
bán: 팔다
cần thiết: 필요하다
siêu thị: 슈퍼
đi, mang (giày): 신다
nhạt, nhạt nhẽo: 싱겁다
gói: 싸다
núi Halla: 한라산
cửa hàng giảm giá: 할인점
túi xách tay: 핸드백