Từ vựng liên quan đến phim ảnh :(영화 관련 어휘)
Phim tâm lý xã hội: 멜로 영화  
Phim kinh dị: 공포 영화  
Phim khoa học viễn tưởng: 에스에프(SF) 영화  
Phim hành động: 액션 영화  
Phim hài: 코미디 영화  
Phim hoạt hình: 애니메이션 영화  
Các thuật ngữ liên quan đến phim :(영화 관련 용어)
Tên phim: 영화 제목  
Đạo diễn phim: 영화감독  
Diễn viên: 영화배우  
Diễn xuất: 연기하다  
Trình chiếu: 상영하다  
Vé xem phim: 영화표  
Công chiếu, phát hành: 개봉하다  
Cảm xúc khi xem phim :(영화를 보면서 느끼는 감정)
Vui mừng: 기쁘다  
Buồn: 슬프다  
Vui (chung): 즐겁다  
Hạnh phúc: 행복하다  
Buồn tê (chán nản): 지루하다  
Cô đơn: 외롭다  
Buồn thảm: 우울하다  
Sợ hãi: 무섭다  
Ngạc nhiên: 놀라다  
Buồn cười: 웃기다  
Buồn chán (không có việc gì làm): 심심하다  
Thích thú, hứng khởi: 신나다  
Giận dữ: 화나다  
Buồn ngủ: 졸리다  
Giá: 값  
Vũ trụ: 우주  
Tìm kiếm: 검색하다  
Cảnh trí: 경치  
Bài báo: 기사  
Quý trọng: 소중하다  
Giờ chiếu: 상영 시간  
Chia ly: 이별  
Có sức hút, được yêu thích: 인기  
Đẹp trai: 잘생기다  
Thon thả: 날씬하다  
Người yêu: 애인  
Chiến tranh: 전쟁  
Bán hết: 매진  
Tương lai: 미래  
Rạp chiếu phim: 영화관  
Tốt nhất, tuyệt nhất: 최고  
Bán: 판매  
Câu cá ở biển: 바다낚시  
Việc đặt mua trước: 예매  
Tưởng tượng: 상상하다  
