Artificial brain implant : Cấy ghép não nhân tạo
Artificial intelligence : Trí tuệ nhân tạo
Blockchain : Chuỗi khối
Computer built into clothing : Quần áo thông minh
Cloud computing : Điện toán đám mây
Direct links between brain and computer : Kết nối trực tiếp giữa não người và máy tính
Electronic humans : Người điện tử
EVA (Electronic Virtual Assistant) : Trợ lý ảo điện tử
Firefighting robot : Robot cứu hỏa
Hydraulic chair for virtual reality games : Ghế thủy lực cho các trò chơi thực tế ảo
Intranets dominate over Internet : Mạng nội bộ chiếm ưu thế
Personal wearable health monitor : Thiết bị theo dõi sức khỏe cá nhân
Terabit per second on optical fiber : Tốc độ terabit/giây trên cáp quang
Game development : Phát triển game
Mobile application development : Phát triển ứng dụng di động
Robotic pets : Thú cưng robot
Robotic devices within blood vessels : Thiết bị robot bơi trong mạch máu
Radio Frequency Identification : Nhận dạng qua tần số vô tuyến
Barcode : Mã vạch
Catch up with : Theo kịp
Convergence : Sự hội tụ
Humanoid : Giống con người
Imagine : Tưởng tượng
Imitate : Bắt chước
Impact : Ảnh hưởng
Influence on : Ảnh hưởng đến
Outstrip : Vượt xa
Radio-frequency tag : Thẻ nhận dạng qua tần số vô tuyến
Revolutionize : Cách mạng hóa
Surveillance : Sự giám sát
Tackle with : Giải quyết, khắc phục
Take over : Chiếm lĩnh