Accounting software: Phần mềm kế toán
Adobe Reader: Phần mềm đọc file PDF
Bioinformatics: Việc sử dụng tin học để phân tích dữ liệu sinh học
Corel Draw: Phần mềm biên tập đồ họa vector
Cost analysis: Phân tích chi phí
Data management: Quản lý dữ liệu
Desktop publishing (DTP): Kỹ thuật chế bản điện tử
Desktop publishing software: Phần mềm chế bản điện tử
Digital assistant: Thiết bị hỗ trợ kỹ thuật số
Dream Weaver: Phần mềm soạn thảo, xây dựng trang web
Editor: Trình biên soạn
Enterprise software: Phần mềm điều hành doanh nghiệp
Graphics program: Phần mềm đồ họa, chương trình đồ họa
Household apps: Ứng dụng dành cho gia đình
Image editing software: Phần mềm chỉnh sửa ảnh
Mobile apps: Ứng dụng di động
Office suite (Word, Excel, PPT): Bộ ứng dụng văn phòng
Payroll: Bảng lương
Primitive: Khối hình cơ bản
Photoshop: Phần mềm chỉnh sửa ảnh
Be supposed to: Giả định là, giả sử là
Benefit: Được hưởng lợi từ
Downsize: Thu nhỏ lại
Enhance: Nâng cao
Keep track of: Theo dõi
Optimize: Tối ưu hóa
Own: Sở hữu, làm chủ
Preserve: Bảo tồn, giữ gìn
Retouch: Chỉnh sửa lại
Simulate: Minh họa, mô phỏng